Name	Motif sequence	Barcode	Complete Sequence
CTCF_wt1	ATAGCGCCCCCTAGTGGCCA	taatag	catgtaGCATGCtaatagATAGCGCCCCCTAGTGGCCAtaatagGCTAGCcatgta
CTCF_sc1	CCCACGGGTGGCCAACCATT	attatt	catgtaGCATGCattattCCCACGGGTGGCCAACCATTattattGCTAGCcatgta
CTCF_wt2	TGGCCACCAGGGGGCGCTA	tgagga	catgtaGCATGCtgaggaTGGCCACCAGGGGGCGCTAtgaggaGCTAGCcatgta
CTCF_sc2	GGCAGGGAGGACCCCGTTC	tgatga	catgtaGCATGCtgatgaGGCAGGGAGGACCCCGTTCtgatgaGCTAGCcatgta
FoxA1_wt	TCCATGTTTACTTTG	aaagtg	catgtaGCATGCaaagtgTCCATGTTTACTTTGaaagtgGCTAGCcatgta
FoxA1_sc	TATTGGTCTCTATTC	ttgtga	catgtaGCATGCttgtgaTATTGGTCTCTATTCttgtgaGCTAGCcatgta
FoxD3_wt	GAATGTTTGTTT	tgagaa	catgtaGCATGCtgagaaGAATGTTTGTTTtgagaaGCTAGCcatgta
FoxD3_sc1	ATTAGTTTGTGT	aagtgt	catgtaGCATGCaagtgtATTAGTTTGTGTaagtgtGCTAGCcatgta
FoxD3_sc2	TTGGTAGTTTAT	tagggg	catgtaGCATGCtaggggTTGGTAGTTTATtaggggGCTAGCcatgta
GATA_wt	TCTTATCTCCC	agtagg	catgtaGCATGCagtaggTCTTATCTCCCagtaggGCTAGCcatgta
GATA_sc	CTTCACTTCCT	tgggat	catgtaGCATGCtgggatCTTCACTTCCTtgggatGCTAGCcatgta
ER_wt	AAGGTCACGGTGACCTG	agaagt	catgtaGCATGCagaagtAAGGTCACGGTGACCTGagaagtGCTAGCcatgta
ER_sc	GTAACTCCGAGTGAGGC	aataga	catgtaGCATGCaatagaGTAACTCCGAGTGAGGCaatagaGCTAGCcatgta
GR_wt	GGGTACATAATGTTCCC	atgtta	catgtaGCATGCatgttaGGGTACATAATGTTCCCatgttaGCTAGCcatgta
GR_sc	CACCTAGAAGTGTGCTT	atgtgg	catgtaGCATGCatgtggCACCTAGAAGTGTGCTTatgtggGCTAGCcatgta
Nanog_wt	GGGCCCATTTCC	ttaagg	catgtaGCATGCttaaggGGGCCCATTTCCttaaggGCTAGCcatgta
Nanog_sc	CCTAGGTCCCTG	tataga	catgtaGCATGCtatagaCCTAGGTCCCTGtatagaGCTAGCcatgta
Oct4_wt_new	ATTTGCAT	aatggt	catgtaGCATGCaatggtATTTGCATaatggtGCTAGCcatgta
Oct4_sc_new	TTTAACTG	tgtgag	catgtaGCATGCtgtgagTTTAACTGtgtgagGCTAGCcatgta
Klf4_wt	TGGGCGGGGC	tgggag	catgtaGCATGCtgggagTGGGCGGGGCtgggagGCTAGCcatgta
Klf4_sc	GGTCCGGGGG	tatgtg	catgtaGCATGCtatgtgGGTCCGGGGGtatgtgGCTAGCcatgta
Klf7_wt	ACGCCC	tagtgt	catgtaGCATGCtagtgtACGCCCtagtgtGCTAGCcatgta
Klf7_sc	CCGCAC	tttgaa	catgtaGCATGCtttgaaCCGCACtttgaaGCTAGCcatgta
Sox2_wt	CCTTTGTT	ttagtg	catgtaGCATGCttagtgCCTTTGTTttagtgGCTAGCcatgta
Sox2_sc	TCTGTCTT	tagaag	catgtaGCATGCtagaagTCTGTCTTtagaagGCTAGCcatgta
Sox9_wt	ACAAAGGGCCCTTTGT	ttgtta	catgtaGCATGCttgttaACAAAGGGCCCTTTGTttgttaGCTAGCcatgta
Sox9_sc	GGCTAGTCTCATGCAA	tagata	catgtaGCATGCtagataGGCTAGTCTCATGCAAtagataGCTAGCcatgta
Sox17_wt	TTCATTGTC	tattat	catgtaGCATGCtattatTTCATTGTCtattatGCTAGCcatgta
Sox17_sc	TTTCAGTCT	ttgggt	catgtaGCATGCttgggtTTTCAGTCTttgggtGCTAGCcatgta
Nrf1_wt	GCGCCTGCGCA	agatat	catgtaGCATGCagatatGCGCCTGCGCAagatatGCTAGCcatgta
Nrf1_sc	TCGAGCCCGGC	tgtatt	catgtaGCATGCtgtattTCGAGCCCGGCtgtattGCTAGCcatgta
PU.1_wt	AAAAAGCGGAAGTA	tttttt	catgtaGCATGCttttttAAAAAGCGGAAGTAttttttGCTAGCcatgta
PU.1_sc	GAAGATCGAAGAAA	aatata	catgtaGCATGCaatataGAAGATCGAAGAAAaatataGCTAGCcatgta
Runx1_wt	GTCTGTGGTTT	taaaaa	catgtaGCATGCtaaaaaGTCTGTGGTTTtaaaaaGCTAGCcatgta
Runx1_sc	TTTGTGCTGGT	atgggt	catgtaGCATGCatgggtTTTGTGCTGGTatgggtGCTAGCcatgta
E2F1_wt	TTTCGCGC	atgtga	catgtaGCATGCatgtgaTTTCGCGCatgtgaGCTAGCcatgta
E2F1_sc	TCGCTTCG	aaggag	catgtaGCATGCaaggagTCGCTTCGaaggagGCTAGCcatgta
ETS_wt	ACCGGAAGTG	atgggg	catgtaGCATGCatggggACCGGAAGTGatggggGCTAGCcatgta
ETS_sc	GCCGAAAGTG	atggtt	catgtaGCATGCatggttGCCGAAAGTGatggttGCTAGCcatgta
NFY_wt	AGAGTGCTGATTGGTCCA	aaaaga	catgtaGCATGCaaaagaAGAGTGCTGATTGGTCCAaaaagaGCTAGCcatgta
NFY_sc	TTGGGAGTACTGGTACAC	tgtggg	catgtaGCATGCtgtgggTTGGGAGTACTGGTACACtgtgggGCTAGCcatgta
OTX2_wt	TTAATCCC	ttttaa	catgtaGCATGCttttaaTTAATCCCttttaaGCTAGCcatgta
OTX2_sc	ATATCCCT	tgaaga	catgtaGCATGCtgaagaATATCCCTtgaagaGCTAGCcatgta
N-myc_wt	GCCACGTG	aaaaaa	catgtaGCATGCaaaaaaGCCACGTGaaaaaaGCTAGCcatgta
N-myc_sc	CATGCGGC	tagtat	catgtaGCATGCtagtatCATGCGGCtagtatGCTAGCcatgta
Kaiso_wt	CTCTCGCGAGATCTG	aatatg	catgtaGCATGCaatatgCTCTCGCGAGATCTGaatatgGCTAGCcatgta
Kaiso_sc	GTTTCGCGGACTCAC	agaggg	catgtaGCATGCagagggGTTTCGCGGACTCACagagggGCTAGCcatgta
Creb_wt	TGACGTCA	tagaga	catgtaGCATGCtagagaTGACGTCAtagagaGCTAGCcatgta
Creb_sc	AATCGGTC	aatgta	catgtaGCATGCaatgtaAATCGGTCaatgtaGCTAGCcatgta
REST_wt	TTCAGCACCATGGACAGCGCC	aaaagt	catgtaGCATGCaaaagtTTCAGCACCATGGACAGCGCCaaaagtGCTAGCcatgta
REST_sc	CAGTTACAGCCCCCAGTCGGA	tgggaa	catgtaGCATGCtgggaaCAGTTACAGCCCCCAGTCGGAtgggaaGCTAGCcatgta
Pax7_wt1	TAATCGATTA	atagga	catgtaGCATGCataggaTAATCGATTAataggaGCTAGCcatgta
Pax7_sc1	TATACGATAT	tggata	catgtaGCATGCtggataTATACGATATtggataGCTAGCcatgta
Pax7_wt2	CTAATTAG	atagaa	catgtaGCATGCatagaaCTAATTAGatagaaGCTAGCcatgta
Pax7_sc2	AAATCTTG	taaatg	catgtaGCATGCtaaatgAAATCTTGtaaatgGCTAGCcatgta
c-Rel_wt	GGGGATTTCC	aatttt	catgtaGCATGCaattttGGGGATTTCCaattttGCTAGCcatgta
c-Rel_sc	TCCTTGGGAG	ttgtat	catgtaGCATGCttgtatTCCTTGGGAGttgtatGCTAGCcatgta
Oct4-Sox2_wt	CTTTGTTATGCAAAT	aagagt	catgtaGCATGCaagagtCTTTGTTATGCAAATaagagtGCTAGCcatgta
Oct4-Sox2_sc	ATACTGTGAATCTTT	tgaaag	catgtaGCATGCtgaaagATACTGTGAATCTTTtgaaagGCTAGCcatgta
ZF5_Zfp161_wt	GCGCGCG	atttaa	catgtaGCATGCatttaaGCGCGCGatttaaGCTAGCcatgta
ZF5_Zfp161_sc	CCGGGCG	tttggt	catgtaGCATGCtttggtCCGGGCGtttggtGCTAGCcatgta
No_Motif	ccggt	catgtaGCATGccggtGCTAGCcatgta	catgtaGCATGCccggtGCATGCcatgta
